###########
#       #R#
#  #    # #
#S #    # #
#  #      #
#     #   #
#         #
###########